11111111
100C0001
10100101
1E1001C1
101C0001
10000001
1P100011
11111111