11111111
100C01C1
101001C1
1E1001C1
101C0001
10000001
1P100011
11111111