11111111
1P100101
10100101
10101001
1010E001
10000011
101C0011
11111111