11111111
100C01C1
101001C1
1E101C01
101C0001
10000011
101P0011
11111111