11111111
1P1C01C1
101001C1
10101C01
101C0001
10000011
1010E011
11111111