11111111
1P100101
1E100101
10101001
10100001
10000011
101C0011
11111111