11111111
1P1C01C1
101001C1
10101CE1
101C0001
10000011
10100011
11111111