11111111
10000001
10100101
1E1001C1
10100001
10100001
1P100011
11111111