111111111111111111111111
1000000Z0000000C00000001
101001010010000010110101
1E1001001010101000110101
100000000C00C000000000C1
100000000C00C000000000C1
1P1000000100100001000C01
100000000100100000000001
111111111111111111111111