1111111111111
10011E11000C1
10C0011111001
1P001101C0001
1111111111111