11111111
111011P1
11C0C000
11111111
