11111111
111P11E1
11C1C001
11111111
