11111111
111011P1
11E0C001
11111111