11111111
111P11C1
111EC001
11111111