11111111111111
10E00000000001
1000PCC1111111
11111111111111