11111111
101P01C1
1C0E0001
11111111