11111111
101P01C1
1C0000E1
11111111