11111111
101P01C1
1000E001
1111C111