11111111
101000C1
1C0000E1
11111111
